12
SFFFFFHHFFFF
FFFFFHFFFFHH
FHFFFHFFFHHF
HHFFFFFFFFHF
FHFFFHFFFHFF
FFFFFFFFFHFF
FFHFFFFHFHFF
FFFFHFHHFFFF
HFFFFHFFFFFH
FFFFHFFFFHFF
HFFFFFFFFFFF
FFHHFFFFFFFG
