12
SFFHFFFFFFFH
FFHFHHFFFFFF
FFFFFFFFFFFH
FFFFFHFFFFHF
FHFFFHFFFFFF
FHFHFFHFFFFF
FFFFFFFFFFFF
HFFHFFFFFFFF
FFFHHFHFFFFF
HFFFFFFFFFFF
FFFFFHFFFFFF
HFHFFHHFFFFG
