12
SFFFHFFHFFFF
FHFFFFHFFFFF
FHHFFFFFFHHH
FFFHHHFFFFFH
FFHFFFFFFFFF
FFFHHFFHFFHF
FFFFFFFFFFFF
HFHFFFFFFFFF
FFFFFFHFHHFH
FFFFHFFHFFFH
HFHHFFFFFHFF
FHFFFFFFFHFG
