12
SFFHHFFFFFFH
FFFHHFFFFFFF
HFHHFFHFFHFF
FFHFFFHFHFHF
HFFHFFFHFFFF
HHFHFFFFHFHF
FFFFFFFFFHFF
FFHFFFFHFFFF
FFFHHFFHFFFF
FFFFHFFFFFFF
FHHFHFFFFFFF
FFHFFFHFFFFG
