12
SFFFHFFFFFHF
FFFFFFFFFHFF
FFFFFFFHFHFF
FFFFFFFFFHFF
FFFFFFFFFFFF
HFHFHFFFFFFF
HFHFFFFFFFFH
FFFFFFFFHFFF
FFFFFFFFFFHF
FFFFFFHFFFFF
FFFFFFFFFFFF
FFFFFFFFFFFG
