12
SFFHFHFFFFHF
HHFFFHFFFHFF
FFHFFFFFFFFF
HFFFHFFHFHHF
FFFFFFFFHFFF
FFFFHFFFFFFF
FFFFFFFHFFFF
HFFHFFFFFHFH
HFFFFFFHFFFF
FFFFFHFFHHFF
FFFFFHHHHHFF
FFFHFFHFHFFG
