12
SFFFFFFHFFHF
FFHFFFFFHFFF
HFHFHFFFFFFF
HFFFFFFHFFFH
FFHFFFFHFHHF
FFFFFFFFHFFF
FFHFFHHFHFFF
FFFFFFFFHFFF
FFFFFFFFFFFF
FFFFFHFHFHFF
FFFHFFHFFFFF
FFFFFFFHFHFG
