12
SFFFFHFFFFFF
FFFFFFFFFFFF
FFHFFFHFFFHH
HFFFFFFFFHFF
FFFHFHHHFFFF
HFFFFFFFFFFF
FFFFFHFFFFFH
FFFFFFFHFFHH
FFFFFHFFFFFH
HFHFFFFFFFHF
FFFFFFFFFHFF
FFFFFFFHFFFG
