12
SFHFFHFFFFFF
FFFFFFFFFFFF
FFFFFFFFFFFF
FFFFFFFFFFFF
FFFFFFFHHFFH
FFFFFFFHFHFF
FFFHHHFFFHHF
FFFFFHFFFFFF
FFHFFFFFHFHF
FFFFFHFFFFFF
HFFFFFFFFFHF
HFHFFFHHFHHG
