12
SFFHFFFFFFHH
FFFFFHHFFHFH
HFFFFFFFFFFF
FFFFFFFFFFFH
FFFFFFFHFFHF
HFFFFFFHHFFF
HHFFHFFFFFHF
HFFFFFHFFFFH
FFFFFHHFFFFF
HFFFFFHFHFFH
FFFFFFHFFHHF
FFFFFHFFFFFG
