8
SFFHFFFF
FFFHFFHF
HHFFFFFF
FFFFFFFF
FFFHFFFF
FHFFFFHF
FHFFFHFF
FFFFFHFG
