8
SFFFFFFF
FFFFFHFF
FFFHFFFF
FFFHFFHH
FFFFFHFF
FFFHHFHF
FFFFFFHF
FFFFFFFG
