8
SFFFHFFH
FFFFFHFF
FFHFFFFF
FHHFFFFF
FHHHFFFH
HHFFFFFH
FFHFFFFF
FFFFFFFG
