8
SFHFFHFF
FFFHFHFF
FFHFFFHH
FFFFFFFH
FFFFFFFF
FHFFHHFF
FFFFFFFF
FFFFFFFG
