8
SFFHFHFF
FFHFHHFF
FHFFFHFF
FFHFFFFF
FFFFHFFF
HFFHFHHF
FFFFFFFF
HFFFFFFG
