8
SFFFFFFH
FFHFFFHF
FFFFHFFF
HFHFHFFF
FFFFHFFF
FFFHFFFH
FFHFFFFH
FHHFFFFG
