8
SFFHHFFF
FFFHFFFH
HFFFFFFF
HFHHFFHF
FHFFFFHF
FFHFHFHF
HFFHFFFH
FFFFHHFG
