8
SFHHFFFH
FFFFHFFF
FFFFFHFF
FFFFFHFF
FFHFFFFH
FFFFFFFF
FHHFHFFF
FFFFFFFG
