8
SFFFHFFF
FFHFFFFF
FFFFFHFF
FFFFFFFH
FHFFFFFF
FFFFFHFF
FFFFFFFF
FFFFHFHG
