12
SFHFFFFFFFFF
FFFFHFFFFFHF
FHFFFFFHFHFF
FFHFHFHFFFFF
FFFFHHFHFFFF
FFFFFHFFFFFH
FFFFHFFFFFHF
FFFHFFHFFFFF
FFFFFFFFHHFF
FFFFFFHHFFHF
FFFFFHHFFFHF
HFHFFFFFFFHG
