fitness,finished,diversity,individual
22,True,43,"(2, 2, 2, 2, 1, 1, 1, 1, 1, 2, 2, 2, 2, 1, 1, 2, 2, 1, 1, 1, 2, 1)"
22,True,48,"(2, 2, 1, 1, 2, 2, 1, 1, 1, 2, 2, 2, 2, 1, 1, 1, 1, 1, 1, 2, 2, 2)"
12,False,90,"(2, 1, 2, 1, 2, 1, 1, 1, 2, 1, 2, 1)"
22,True,48,"(2, 2, 1, 1, 1, 1, 2, 1, 2, 2, 2, 2, 2, 1, 1, 2, 2, 1, 1, 1, 2, 1)"
22,True,49,"(1, 2, 2, 2, 2, 1, 1, 2, 2, 1, 1, 2, 2, 1, 1, 1, 2, 2, 1, 2, 1, 1)"
22,True,59,"(1, 2, 2, 2, 1, 2, 1, 2, 2, 1, 2, 2, 1, 1, 1, 2, 1, 2, 1, 2, 1, 1)"
22,True,45,"(2, 2, 2, 1, 1, 1, 1, 1, 2, 2, 2, 2, 2, 1, 1, 1, 2, 2, 1, 1, 2, 1)"
22,True,52,"(1, 2, 2, 2, 2, 1, 1, 1, 1, 2, 2, 2, 2, 1, 1, 2, 1, 2, 1, 1, 1, 2)"
18,False,55,"(1, 2, 2, 1, 1, 1, 2, 1, 2, 2, 2, 2, 2, 1, 1, 2, 2, 2)"
22,True,62,"(1, 2, 2, 2, 1, 2, 1, 1, 1, 2, 2, 2, 2, 1, 1, 2, 1, 2, 1, 2, 1, 1)"
22,True,57,"(2, 2, 2, 1, 1, 1, 1, 1, 2, 2, 2, 2, 2, 1, 1, 1, 2, 2, 1, 2, 1, 1)"
22,True,39,"(2, 2, 1, 1, 1, 2, 1, 1, 1, 1, 1, 1, 1, 2, 1, 2, 2, 2, 2, 2, 2, 2)"
22,True,44,"(2, 2, 2, 1, 1, 1, 1, 1, 1, 1, 1, 1, 1, 2, 1, 2, 2, 2, 2, 2, 2, 2)"
22,True,48,"(2, 1, 2, 1, 1, 2, 1, 2, 1, 2, 2, 2, 2, 1, 1, 1, 2, 2, 1, 1, 1, 2)"
22,True,47,"(2, 2, 1, 2, 1, 1, 2, 2, 2, 1, 1, 2, 2, 1, 1, 1, 2, 2, 1, 2, 1, 1)"
12,False,89,"(1, 2, 2, 2, 2, 1, 1, 1, 1, 1, 2, 1)"
22,True,45,"(2, 2, 1, 1, 1, 1, 2, 1, 1, 1, 1, 1, 1, 2, 2, 2, 2, 2, 2, 1, 2, 2)"
22,True,41,"(1, 2, 2, 1, 1, 2, 1, 1, 1, 1, 1, 1, 1, 2, 2, 2, 2, 2, 2, 1, 2, 2)"
22,True,47,"(1, 2, 2, 1, 2, 1, 2, 1, 1, 2, 2, 2, 2, 1, 1, 1, 1, 1, 2, 1, 2, 2)"
22,True,50,"(2, 2, 1, 2, 2, 1, 1, 1, 1, 2, 2, 2, 2, 1, 1, 2, 1, 2, 1, 2, 1, 1)"
22,True,45,"(2, 2, 1, 1, 2, 2, 1, 1, 1, 2, 2, 2, 2, 1, 1, 1, 2, 2, 1, 2, 1, 1)"
12,False,75,"(1, 2, 2, 1, 1, 1, 1, 2, 1, 2, 2, 1)"
22,True,64,"(2, 2, 2, 1, 1, 2, 1, 1, 1, 2, 2, 2, 2, 1, 1, 2, 1, 2, 1, 2, 1, 1)"
12,False,75,"(2, 2, 1, 1, 1, 2, 1, 1, 2, 2, 1, 1)"
22,True,57,"(1, 2, 2, 2, 2, 1, 1, 2, 2, 2, 1, 1, 2, 1, 1, 1, 2, 2, 1, 1, 2, 1)"
22,True,48,"(2, 2, 2, 2, 1, 1, 1, 1, 1, 2, 2, 2, 2, 1, 1, 1, 1, 1, 2, 2, 2, 1)"
22,True,42,"(2, 1, 2, 1, 1, 2, 2, 2, 2, 2, 2, 1, 1, 1, 1, 1, 2, 2, 1, 2, 1, 1)"
22,True,56,"(2, 2, 1, 2, 1, 2, 1, 2, 2, 1, 1, 2, 2, 1, 1, 2, 2, 1, 1, 2, 1, 1)"
22,True,54,"(2, 2, 1, 2, 1, 2, 1, 1, 1, 2, 2, 2, 2, 1, 1, 2, 1, 2, 1, 2, 1, 1)"
22,True,57,"(2, 2, 1, 2, 1, 1, 2, 2, 2, 1, 2, 1, 2, 1, 1, 2, 2, 1, 1, 1, 2, 1)"
